11111111111
1C000C000P1
11110000001
11111100001
1E000C000C1
11111111111
