11111111111
100000000P1
1C111100111
11100000001
1E101100101
10111100101
100000001C1
11111111111
