11111111111
100000000P1
11110000001
11111100001
1E000000001
11111111111
