11111111111
1C0000000P1
11110000001
11111100001
10000000001
11111111111
