11111111111
100000000P1
11110000001
11111100111
1E0000001C1
11111111111
