11111111111
1C000000001
11110000001
11111100001
1E000000001
11111111111
