11111111111
1C0000000P1
11110000001
11111100000
1E000000001
11111111111
